					1,2,3,4,5,1,1,1,1,6,7,8,9,1,1,11,12,12,12,12,12,12,12,13,14,15,12,12,16,17,18,19,19,19,19,20,19,19,19,19,20,19,19,19,21,22,23,105,106,18,
					1,26,27,28,29,1,1,1,1,222,221,220,219,1,1,11,12,12,12,12,12,12,12,13,14,15,12,12,30,31,32,96,96,96,96,96,96,96,96,96,96,96,96,96,96,34,104,105,106,18,
					36,37,38,39,40,1,1,1,228,227,226,225,224,223,1,11,12,12,12,12,42,43,43,44,14,45,43,46,47,48,136,136,136,49,136,136,136,136,49,136,136,136,136,136,51,23,105,105,106,18,
					52,53,54,55,56,1,1,1,234,233,232,231,230,229,1,11,12,12,12,42,44,14,58,59,59,59,59,60,61,216,141,141,141,64,213,141,141,141,141,141,141,141,141,141,65,23,105,105,106,18,
					1,1,66,67,1,1,1,1,240,239,238,237,236,235,1,11,12,12,42,44,14,58,60,12,12,12,12,12,69,145,145,145,145,145,145,145,145,145,145,145,145,145,145,145,71,72,140,105,106,18,
					1,1,1,1,1,1,1,1,246,245,244,243,242,241,1,11,12,12,13,14,58,60,12,12,12,12,12,12,16,17,18,19,19,19,19,19,19,19,19,19,19,19,19,19,19,92,23,105,106,18,
					1,1,1,1,1,1,1,1,1,1,1,1,1,1,76,77,12,12,13,14,15,12,12,12,12,12,12,12,16,17,18,19,19,20,19,19,19,19,19,19,19,19,19,20,19,92,23,105,106,18,
					300,300,300,1,300,300,300,300,300,300,1,300,300,300,78,79,12,12,13,14,15,12,12,12,12,12,12,12,16,17,18,19,19,19,19,19,19,19,20,19,19,19,19,19,19,92,23,105,106,18,
					80,80,80,81,82,82,82,80,80,80,81,82,82,82,83,84,12,12,13,14,15,12,12,12,12,12,12,12,85,17,18,21,86,86,86,86,86,19,19,19,19,19,19,19,19,92,23,105,106,97,
					87,87,87,88,89,89,89,87,87,87,88,89,89,89,90,91,12,12,13,14,45,46,12,12,12,12,12,12,85,17,18,92,12,93,94,94,95,96,96,96,96,96,96,96,96,34,104,105,134,108,
					12,12,98,14,100,12,12,12,12,98,14,100,12,12,12,12,12,12,102,103,14,45,46,12,12,12,12,12,85,17,18,92,93,104,105,105,106,47,136,49,136,136,136,136,51,23,105,105,105,105,
					12,12,102,103,45,46,12,12,42,44,58,60,12,12,12,12,12,12,12,102,103,14,45,46,12,12,12,12,85,17,18,92,110,105,105,105,106,61,141,141,64,213,141,141,65,23,105,105,105,105,
					12,12,42,44,58,60,12,12,102,103,45,46,12,12,12,12,12,12,12,12,102,103,14,45,46,12,12,12,85,17,18,92,110,105,113,114,115,69,145,145,145,145,145,145,71,72,140,105,113,117,
					12,12,102,103,45,46,12,12,42,44,58,60,12,12,12,12,12,12,42,46,12,102,103,14,45,46,12,12,85,17,18,92,110,105,106,119,120,19,19,19,19,19,19,19,19,121,23,105,106,119,
					12,12,12,102,103,45,43,43,44,58,60,12,12,12,12,12,12,42,44,45,46,12,102,103,14,45,46,12,85,17,18,92,110,105,106,18,19,20,19,19,19,19,20,19,19,92,23,105,106,18,
					12,12,12,42,44,14,14,14,14,45,43,43,43,46,42,43,43,44,14,14,45,46,42,44,14,58,60,12,85,17,18,92,110,105,106,18,19,19,19,19,19,19,19,19,19,92,23,105,106,18,
					43,43,43,44,14,58,59,59,103,14,14,14,14,45,44,14,14,14,58,103,14,45,44,14,58,60,12,12,85,17,18,92,110,105,106,18,19,19,19,19,19,19,19,19,19,92,23,105,106,18,
					14,14,14,14,58,60,12,12,102,59,59,59,103,14,14,58,59,59,60,102,59,103,58,59,60,12,12,12,85,17,18,92,110,105,106,18,19,19,19,19,19,19,19,19,19,92,72,117,128,18,
					59,59,59,59,60,12,12,12,12,12,12,12,102,103,58,60,12,12,12,12,12,102,60,12,12,12,12,12,85,17,18,92,110,105,106,18,19,19,19,19,19,19,19,19,19,126,120,120,120,127,
					12,12,12,12,12,12,12,12,12,12,12,12,12,102,60,12,12,12,12,12,12,12,12,12,12,12,12,12,85,17,18,92,110,105,106,18,19,20,19,19,19,19,20,19,19,19,19,20,19,19,
					129,129,129,129,129,129,129,129,129,129,129,129,129,129,129,129,129,129,129,129,129,129,129,129,129,129,129,129,130,17,18,92,110,105,106,97,86,19,19,19,19,19,19,19,19,86,86,86,86,131,
					132,132,132,132,132,132,132,132,132,132,132,132,132,132,132,132,132,132,132,132,132,132,132,132,132,132,132,132,132,217,18,92,110,105,134,94,95,96,96,96,96,96,96,96,96,93,94,94,95,18,
					120,120,120,120,120,120,120,120,120,120,120,120,120,120,120,120,120,120,120,120,120,120,120,120,120,120,120,120,120,120,127,92,110,105,105,105,106,47,136,136,136,136,136,136,51,110,105,105,106,18,
					19,19,19,135,19,19,19,19,138,19,19,19,19,19,19,138,19,19,135,19,19,19,19,19,19,19,19,19,19,19,19,92,139,140,105,105,106,61,141,141,141,141,141,141,65,110,105,105,106,18,
					142,143,143,143,143,143,143,143,143,143,143,143,143,143,143,143,143,143,144,19,19,19,20,19,19,138,19,19,20,19,19,92,12,139,114,114,115,69,145,145,145,145,145,145,71,139,140,105,106,18,
					146,147,147,147,147,147,147,147,147,147,147,147,147,147,147,147,147,147,148,144,19,19,19,19,19,19,19,19,19,19,19,126,120,120,120,120,120,19,19,19,19,19,19,19,19,92,110,105,106,18,
					150,147,151,152,152,152,152,152,152,152,153,147,147,147,147,147,147,147,147,148,144,19,19,19,19,19,19,19,19,19,19,19,19,19,19,133,19,19,19,19,19,19,19,133,19,92,110,105,106,18,
					147,147,154,155,155,155,155,155,155,155,156,147,147,157,158,159,147,147,147,147,148,144,19,19,19,20,19,19,149,19,21,86,86,86,86,86,86,86,86,86,86,86,86,86,86,22,110,105,106,97,
					147,147,160,161,161,161,161,161,161,161,162,147,147,163,155,164,147,147,147,147,147,148,143,144,19,19,19,19,19,19,92,12,12,12,12,12,12,12,12,12,12,12,12,12,12,12,110,105,106,12,
					147,147,147,147,147,147,147,147,147,147,147,147,147,163,155,164,147,147,147,147,147,147,147,166,86,86,86,86,86,86,22,12,12,12,12,12,12,12,12,12,12,12,12,12,12,93,104,113,115,12,
					147,147,147,147,147,147,147,147,147,147,147,147,147,163,155,164,165,151,152,152,152,152,153,166,12,12,12,12,12,12,12,12,12,12,34,108,108,108,108,108,95,12,12,12,93,104,113,115,12,12,
					147,151,152,152,152,152,153,147,147,147,147,147,147,163,155,164,147,154,155,155,155,155,156,166,12,12,12,12,12,12,12,12,12,34,104,113,117,117,117,140,134,95,12,93,104,113,115,12,12,12,
					147,154,155,155,155,155,156,151,152,152,152,152,153,163,155,164,147,160,161,161,161,161,162,166,167,12,12,12,12,12,12,12,34,104,113,128,12,12,12,139,140,134,108,104,113,115,12,12,12,169,
					147,160,161,161,161,161,162,154,155,155,155,155,156,163,155,164,147,147,147,147,147,147,147,168,134,167,12,12,12,12,12,34,104,113,128,12,12,12,12,12,139,117,117,117,115,12,12,12,12,170,
					147,165,147,147,147,147,147,160,161,161,161,161,162,163,155,164,147,147,147,147,147,147,147,166,140,134,167,12,12,12,34,104,113,128,12,12,169,169,169,169,169,169,169,12,12,169,169,12,169,169,
					147,171,172,172,173,147,147,147,147,147,147,147,147,174,175,176,147,147,147,147,147,147,147,166,72,140,134,108,108,108,104,113,128,12,12,12,170,170,170,170,170,170,170,12,12,170,170,12,170,170,
					147,177,178,178,179,172,172,172,172,172,172,173,147,147,151,152,152,152,152,152,153,147,147,166,12,72,117,117,117,117,117,128,12,169,169,169,169,169,169,169,169,169,169,169,169,169,169,169,169,169,
					147,177,178,178,178,178,180,181,181,181,181,182,147,147,154,155,155,155,155,155,156,147,183,184,12,12,12,12,12,12,12,12,12,170,170,170,170,170,170,170,170,170,170,170,170,170,170,170,170,170,
					147,177,178,178,178,178,187,151,152,152,152,152,153,165,160,161,161,161,161,161,162,183,184,169,169,169,169,169,169,169,169,169,169,169,185,186,169,169,185,186,169,169,169,169,169,169,185,186,169,169,
					147,177,178,178,178,178,187,154,155,155,155,155,156,147,147,147,183,188,188,188,189,166,169,170,170,170,170,170,170,170,170,170,170,170,190,191,170,170,190,191,170,170,170,170,170,170,190,191,170,170,
					147,177,178,178,178,178,187,160,161,161,161,161,162,147,147,147,166,169,169,169,192,184,170,169,185,193,193,193,193,193,193,193,193,194,195,191,169,169,190,196,193,193,193,193,193,193,195,191,169,169,
					147,177,178,178,178,178,179,172,172,172,173,147,147,147,183,188,184,170,170,170,169,169,169,170,190,197,198,199,200,198,199,199,201,199,201,202,170,170,190,198,201,199,200,198,201,199,201,202,170,170,
					147,177,178,178,178,178,178,178,178,178,187,147,147,147,166,203,203,203,203,203,170,170,170,169,190,197,204,169,205,204,169,169,169,169,169,169,169,169,190,191,169,169,205,204,169,169,169,169,169,169,
					147,177,178,178,178,178,178,180,181,181,182,147,183,188,184,203,203,206,207,203,203,203,169,170,215,199,214,170,190,191,170,170,170,170,170,170,170,170,205,191,170,170,205,204,170,170,170,170,170,170,
					147,208,181,181,181,181,218,187,147,147,147,147,166,203,203,203,206,209,210,194,207,203,170,169,169,169,169,169,190,191,169,169,169,169,185,193,193,194,195,191,169,169,190,196,193,193,193,186,169,169,
					147,147,147,147,147,147,177,187,147,183,188,188,184,203,203,206,209,197,211,212,196,207,203,170,170,170,170,170,205,204,170,170,170,170,190,198,199,199,201,202,170,170,190,198,199,199,200,204,170,170,
					147,147,147,147,147,147,177,187,147,166,194,194,194,207,203,205,197,211,214,215,212,196,194,193,193,193,193,194,195,196,194,194,193,194,195,204,169,169,169,169,169,169,190,204,169,169,205,196,169,169,
					147,147,147,147,147,147,208,182,147,168,197,197,197,210,194,209,197,204,203,203,215,201,201,201,199,199,199,199,200,198,199,199,201,199,201,202,170,170,170,170,170,170,190,204,170,170,215,199,170,170,
					151,152,152,152,152,152,152,152,153,166,199,199,199,212,197,197,211,214,203,203,203,203,169,169,169,169,169,169,190,191,169,169,169,169,169,169,169,169,169,169,169,169,190,204,169,169,169,169,169,169,
					154,155,155,155,155,155,155,155,156,166,203,203,203,215,199,199,214,203,203,203,203,203,170,170,170,170,170,170,205,204,170,170,170,170,170,170,170,170,170,170,170,170,190,204,170,170,170,170,170,170